%%%%%%%%%%%%%%%%%%%%
%    %G.......%....%
% %% % %%%%%%.%.%%.%
% %    P  .......%.%
% % %% %% G%%.%%.%.%
% .    %    %......%
% % %%.%%%%%%.%%.%.%
% %          ....%.%
% %% % %%%%%%.%.%%.%
%    %    ....%... %
%%%%%%%%%%%%%%%%%%%%